0000000000000000000000000000000000000000000000000000000000000000000000000000000000000000000000000000
0000011111111111111111111111111111111111111111111111111000000000000000000000000000000000000000000000
0000011..........1.........1...............1..........1000000000000000000000000000000000000000000000
0000011..........1.........1...............1..........1000000000000000000000000000000000000000000000
000001........J..1.........1...............1..........1000000000000000000000000000000000000000000000
000001...........1.........1..........................1000000000000000000000000000000000000000000000
000001...B............................................1000000000000000000000000000000000000000000000
000001................................................1000000000000000000000000000000000000000000000
000001...........1....................................1000000000000000000000000000000000000000000000
000001...........1.........1..........................1000000000000000000000000000000000000000000000
000001...........1.........1..............1...........1000000000000000000000000000000000000000000000
000001...........1.........1.............11...........1000000000000000000000000000000000000000000000
00000111111..11111.........1.............1............1000000000000000000000000000000000000000000000
000001...........1.........1.............1............1111111111111111100000000000000000000000000000
000001...........1.........1.............1............1...............100000000000000000000000000000
000001...........11111111111.............1............1...............100000000000000000000000000000
000001..............1......1.............1............1...............100000000000000000000000000000
000001..............1......1.............1............1...............100000000000000000000000000000
000001..............1......1.............1............1.......B.......100000000000000000000000000000
000001..............11.....1.............1.........1111...............100000000000000000000000000000
000001...............1.....1111......111111111111111..................100000000000000000000000000000
000001...............1................................................100000000000000000000000000000
000001..............11................................................100000000000000000000000000000
000001..11..........1.................................................100000000000000000000000000000
000001...111111111111.................................................100000000000000000000000000000
000001...............1................................................100000000000000000000000000000
000001................1...............................................100000000000000000000000000000
000001.................1..............................................100000000000000000000000000000
000001..................1.............................................100000000000000000000000000000
000001...................1............................................100000000000000000000000000000
000001....................1...........................................100000000000000000000000000000
000001.....................1..........................................100000000000000000000000000000
000011......................1.........................................100000000000000000000000000000
00001........................1........................................100000000000000000000000000000
00001...........P.............1.......................................100000000000000000000000000000
000011.........................1......................................100000000000000000000000000000
000001..........................1.....................................100000000000000000000000000000
000001...........................1...............................X....100000000000000000000000000000
000001......M.....................1...................................100000000000000000000000000000
000001.............................1..................................100000000000000000000000000000
0000011111111111111111111111111111111111111111111111111111111111111111100000000000000000000000000000
0000000000000000000000000000000000000000000000000000000000000000000000000000000000000000000000000000
0000000000000000000000000000000000000000000000000000000000000000000000000000000000000000000000000000
0000000000000000000000000000000000000000000000000000000000000000000000000000000000000000000000000000
0000000000000000000000000000000000000000000000000000000000000000000000000000000000000000000000000000
0000000000000000000000000000000000000000000000000000000000000000000000000000000000000000000000000000
0000000000000000000000000000000000000000000000000000000000000000000000000000000000000000000000000000
0000000000000000000000000000000000000000000000000000000000000000000000000000000000000000000000000000
0000000000000000000000000000000000000000000000000000000000000000000000000000000000000000000000000000
0000000000000000000000000000000000000000000000000000000000000000000000000000000000000000000000000000
0000000000000000000000000000000000000000000000000000000000000000000000000000000000000000000000000000
0000000000000000000000000000000000000000000000000000000000000000000000000000000000000000000000000000
0000000000000000000000000000000000000000000000000000000000000000000000000000000000000000000000000000
0000000000000000000000000000000000000000000000000000000000000000000000000000000000000000000000000000
0000000000000000000000000000000000000000000000000000000000000000000000000000000000000000000000000000
0000000000000000000000000000000000000000000000000000000000000000000000000000000000000000000000000000
0000000000000000000000000000000000000000000000000000000000000000000000000000000000000000000000000000
0000000000000000000000000000000000000000000000000000000000000000000000000000000000000000000000000000
0000000000000000000000000000000000000000000000000000000000000000000000000000000000000000000000000000
0000000000000000000000000000000000000000000000000000000000000000000000000000000000000000000000000000
0000000000000000000000000000000000000000000000000000000000000000000000000000000000000000000000000000
0000000000000000000000000000000000000000000000000000000000000000000000000000000000000000000000000000
0000000000000000000000000000000000000000000000000000000000000000000000000000000000000000000000000000
0000000000000000000000000000000000000000000000000000000000000000000000000000000000000000000000000000
0000000000000000000000000000000000000000000000000000000000000000000000000000000000000000000000000000
0000000000000000000000000000000000000000000000000000000000000000000000000000000000000000000000000000
0000000000000000000000000000000000000000000000000000000000000000000000000000000000000000000000000000
0000000000000000000000000000000000000000000000000000000000000000000000000000000000000000000000000000
0000000000000000000000000000000000000000000000000000000000000000000000000000000000000000000000000000
0000000000000000000000000000000000000000000000000000000000000000000000000000000000000000000000000000
0000000000000000000000000000000000000000000000000000000000000000000000000000000000000000000000000000
0000000000000000000000000000000000000000000000000000000000000000000000000000000000000000000000000000
0000000000000000000000000000000000000000000000000000000000000000000000000000000000000000000000000000
0000000000000000000000000000000000000000000000000000000000000000000000000000000000000000000000000000
0000000000000000000000000000000000000000000000000000000000000000000000000000000000000000000000000000
0000000000000000000000000000000000000000000000000000000000000000000000000000000000000000000000000000
0000000000000000000000000000000000000000000000000000000000000000000000000000000000000000000000000000
0000000000000000000000000000000000000000000000000000000000000000000000000000000000000000000000000000
0000000000000000000000000000000000000000000000000000000000000000000000000000000000000000000000000000
0000000000000000000000000000000000000000000000000000000000000000000000000000000000000000000000000000
0000000000000000000000000000000000000000000000000000000000000000000000000000000000000000000000000000
0000000000000000000000000000000000000000000000000000000000000000000000000000000000000000000000000000
0000000000000000000000000000000000000000000000000000000000000000000000000000000000000000000000000000
0000000000000000000000000000000000000000000000000000000000000000000000000000000000000000000000000000
0000000000000000000000000000000000000000000000000000000000000000000000000000000000000000000000000000
0000000000000000000000000000000000000000000000000000000000000000000000000000000000000000000000000000
0000000000000000000000000000000000000000000000000000000000000000000000000000000000000000000000000000
0000000000000000000000000000000000000000000000000000000000000000000000000000000000000000000000000000
0000000000000000000000000000000000000000000000000000000000000000000000000000000000000000000000000000
0000000000000000000000000000000000000000000000000000000000000000000000000000000000000000000000000000
0000000000000000000000000000000000000000000000000000000000000000000000000000000000000000000000000000
0000000000000000000000000000000000000000000000000000000000000000000000000000000000000000000000000000
0000000000000000000000000000000000000000000000000000000000000000000000000000000000000000000000000000
0000000000000000000000000000000000000000000000000000000000000000000000000000000000000000000000000000
0000000000000000000000000000000000000000000000000000000000000000000000000000000000000000000000000000
0000000000000000000000000000000000000000000000000000000000000000000000000000000000000000000000000000
0000000000000000000000000000000000000000000000000000000000000000000000000000000000000000000000000000
0000000000000000000000000000000000000000000000000000000000000000000000000000000000000000000000000000
0000000000000000000000000000000000000000000000000000000000000000000000000000000000000000000000000000
0000000000000000000000000000000000000000000000000000000000000000000000000000000000000000000000000000
level4.txt valid