0000000000000000000000000000000000000000000000000000000000000000000000000000000000000000000000000000
0000000000000000000000000000000000000000000000000000000000000000000000000000000000000000000000000000
0000000000000000000000000000000000000000000000000000000000000000000000000000000000000000000000000000
0000000000000000000000000000000000000000000000000000000000000000000000000000000000000000000000000000
0000000000000000000000000000000000000000000000000000000000000000000000000000000000000000000000000000
0000000000000011111111111111111111111111111111111111111111111111111111111110000000000000000000000000
000000000000001........1.........................................1........10000000000000000000000000
000000000000001.........................1......1..................1.......10000000000000000000000000
000000000000001.................................1.........................10000000000000000000000000
000000000000001...........................................................10000000000000000000000000
000000000000001..1................1..................................1....10000000000000000000000000
000000000000001.............1.........................................1...10000000000000000000000000
000000000000001..............1................1.......X...................10000000000000000000000000
000000000000001..........1..1...........................................1.10000000000000000000000000
000000000000001........1.1....1...........................................10000000000000000000000000
000000000000001.....1.....................................................10000000000000000000000000
0000000000000011..........................................................10000000000000000000000000
0000000000000011.......1........1............................1............10000000000000000000000000
000000000000001...........................1...............................10000000000000000000000000
000000000000001............................................1..............10000000000000000000000000
000000000000001......................1.....1.......1......................10000000000000000000000000
000000000000001.......1....................1..............................10000000000000000000000000
000000000000001......................................................1....10000000000000000000000000
000000000000001.................1..1......................................10000000000000000000000000
000000000000001.......1.......1.....................................1.....10000000000000000000000000
000000000000001..............1..........................1.1...............10000000000000000000000000
000000000000001.......1................................11.................10000000000000000000000000
000000000000001.............1..1..........................................10000000000000000000000000
000000000000001............1............1..1....1.........11..............10000000000000000000000000
000000000000001........1..11..1........................1................1.10000000000000000000000000
000000000000001..1.1.....11...........1........1.1...1....................10000000000000000000000000
000000000000001..1.1.....1.....1........................1..1..............10000000000000000000000000
000000000000001.........1...1...1.1.....1..................1..............10000000000000000000000000
000000000000001.......1............................................1......10000000000000000000000000
000000000000001.......1..1....P....................................1......10000000000000000000000000
000000000000001.......................1...............................1...10000000000000000000000000
000000000000001.......1............11...................................1.10000000000000000000000000
000000000000001.............1....11.......1...1..............1............10000000000000000000000000
0000000000000011.................1.1.................1.1................1.10000000000000000000000000
0000000000000001.............1..1....1....................................10000000000000000000000000
0000000000000001.............1.1....................11111111..............10000000000000000000000000
0000000000000001...............1...................1........1.............10000000000000000000000000
0000000000000001.....1......1..1..................1........1.11...........10000000000000000000000000
0000000000000001..1...1........1.................1......1......1..........10000000000000000000000000
0000000000000001...1..1........1.................1..............1.........10000000000000000000000000
0000000000000001...............1...............111...............1........10000000000000000000000000
0000000000000001...............1.......111111..1.1.....B...1......1.......10000000000000000000000000
0000000000000001...............1.......1.........1.................1......10000000000000000000000000
0000000000000001...............1.................1..................1.....10000000000000000000000000
0000000000000001...............1......1..........11.................1.....10000000000000000000000000
0000000000000001.....................1...........11111111...........1.....10000000000000000000000000
0000000000000001...............1....1.............11.1..1111111.....1.....10000000000000000000000000
00000000000000011111111111.........1..............1........111......1.....10000000000000000000000000
00000000000000000000000001........1...............1........1........1.....10000000000000000000000000
00000000000000000000000001......11.................1.....111........1..M..10000000000000000000000000
00000000000000000000000001.J....1..1......1.........11.11...........1.....10000000000000000000000000
00000000000000000000000001..........1...............................1.....10000000000000000000000000
00000000000000000000000001..........................................1.....10000000000000000000000000
00000000000000000000000001................11111111111111111..........1....10000000000000000000000000
000000000000000000000000011...............10000000000000001...........1...10000000000000000000000000
0000000000000000000000000011..............10000000000000001............1..10000000000000000000000000
0000000000000000000000000001....1.........10000000000000001.............1.10000000000000000000000000
000000000000000000000000000111............10000000000000001..............110000000000000000000000000
00000000000000000000000000000111111111111110000000000000001...............10000000000000000000000000
0000000000000000000000000000000000000000000000000000000000111111111111111110000000000000000000000000
0000000000000000000000000000000000000000000000000000000000000000000000000000000000000000000000000000
0000000000000000000000000000000000000000000000000000000000000000000000000000000000000000000000000000
0000000000000000000000000000000000000000000000000000000000000000000000000000000000000000000000000000
0000000000000000000000000000000000000000000000000000000000000000000000000000000000000000000000000000
0000000000000000000000000000000000000000000000000000000000000000000000000000000000000000000000000000
0000000000000000000000000000000000000000000000000000000000000000000000000000000000000000000000000000
0000000000000000000000000000000000000000000000000000000000000000000000000000000000000000000000000000
0000000000000000000000000000000000000000000000000000000000000000000000000000000000000000000000000000
0000000000000000000000000000000000000000000000000000000000000000000000000000000000000000000000000000
0000000000000000000000000000000000000000000000000000000000000000000000000000000000000000000000000000
0000000000000000000000000000000000000000000000000000000000000000000000000000000000000000000000000000
0000000000000000000000000000000000000000000000000000000000000000000000000000000000000000000000000000
0000000000000000000000000000000000000000000000000000000000000000000000000000000000000000000000000000
0000000000000000000000000000000000000000000000000000000000000000000000000000000000000000000000000000
0000000000000000000000000000000000000000000000000000000000000000000000000000000000000000000000000000
0000000000000000000000000000000000000000000000000000000000000000000000000000000000000000000000000000
0000000000000000000000000000000000000000000000000000000000000000000000000000000000000000000000000000
0000000000000000000000000000000000000000000000000000000000000000000000000000000000000000000000000000
0000000000000000000000000000000000000000000000000000000000000000000000000000000000000000000000000000
0000000000000000000000000000000000000000000000000000000000000000000000000000000000000000000000000000
0000000000000000000000000000000000000000000000000000000000000000000000000000000000000000000000000000
0000000000000000000000000000000000000000000000000000000000000000000000000000000000000000000000000000
0000000000000000000000000000000000000000000000000000000000000000000000000000000000000000000000000000
0000000000000000000000000000000000000000000000000000000000000000000000000000000000000000000000000000
0000000000000000000000000000000000000000000000000000000000000000000000000000000000000000000000000000
0000000000000000000000000000000000000000000000000000000000000000000000000000000000000000000000000000
0000000000000000000000000000000000000000000000000000000000000000000000000000000000000000000000000000
0000000000000000000000000000000000000000000000000000000000000000000000000000000000000000000000000000
0000000000000000000000000000000000000000000000000000000000000000000000000000000000000000000000000000
0000000000000000000000000000000000000000000000000000000000000000000000000000000000000000000000000000
0000000000000000000000000000000000000000000000000000000000000000000000000000000000000000000000000000
0000000000000000000000000000000000000000000000000000000000000000000000000000000000000000000000000000
0000000000000000000000000000000000000000000000000000000000000000000000000000000000000000000000000000
0000000000000000000000000000000000000000000000000000000000000000000000000000000000000000000000000000
0000000000000000000000000000000000000000000000000000000000000000000000000000000000000000000000000000
level1.txt valid