0000000000000000000000000000000000000000000000000000000000000000000000000000000000000000000000000000
0000011111111111111111111111111111111111111111111111111000000000000000000000000000000000000000000000
0000011...............................................1000000000000000000000000000000000000000000000
0000011.......................................1.......1000000000000000000000000000000000000000000000
000001.......11111111111111111111.............1.......1000000000000000000000000000000000000000000000
000001.......1................................1.......1000000000000000000000000000000000000000000000
000001........1...............................11......1000000000000000000000000000000000000000000000
000001........1.....................1..........1......1000000000000000000000000000000000000000000000
000001........1.....................1..........1......1000000000000000000000000000000000000000000000
000001........1.....................1..........1......1000000000000000000000000000000000000000000000
000001.......1.....................1...........1......1000000000000000000000000000000000000000000000
000001.......1............J........1...........1......1000000000000000000000000000000000000000000000
000001.......1.....P......1........1...........11.....1000000000000000000000000000000000000000000000
000001......1............1.........1...........11.....1111111111111111100000000000000000000000000000
000001.....11...........1..........1...........11.....1...............100000000000000000000000000000
000001.....1...........1...........1............1.....1...............100000000000000000000000000000
000001.....1..........1............1.....11.....1.....1...............100000000000000000000000000000
000001.....1.........1.............1....1.......1.....1...............100000000000000000000000000000
000001.....1......M1........11111111...1........1.....1.......B.......100000000000000000000000000000
000001.....1......1........1..........1.........1.....1...............100000000000000000000000000000
000001.....1.......1......1..........1................1...............100000000000000000000000000000
000001.....1........1...............1.................1...............100000000000000000000000000000
000001...111.........1..............1.................1...............100000000000000000000000000000
000001...1............1.............1.................111111..........100000000000000000000000000000
000001...1.............1............1......................1..........100000000000000000000000000000
000001...1...1..........1...........1......................1..........100000000000000000000000000000
000001.......1...........1..........1......................1..........100000000000000000000000000000
000001.......1............1.........1......................1..........100000000000000000000000000000
000001.......11............1.......11.....................1111........100000000000000000000000000000
000001........1.............1......11.....11111111....................100000000000000000000000000000
000001........1.............1......11.....1...........................100000000000000000000000000000
000001........1.....1.......1......1......1...........................100000000000000000000000000000
000011........1....11..............1......1...........................100000000000000000000000000000
00001.........1.....1..............1......1...........................100000000000000000000000000000
00001...11....1.....1..............1......1...........................100000000000000000000000000000
000011...1....1.....1...1.........11......1...........X...............100000000000000000000000000000
000001...1....1.....111111111111111.....11............................100000000000000000000000000000
000001...1....1.......................................................100000000000000000000000000000
000001...1....1.......................................................100000000000000000000000000000
000001...1....1.......................................................100000000000000000000000000000
0000011111111111111111111111111111111111111111111111111111111111111111100000000000000000000000000000
0000000000000000000000000000000000000000000000000000000000000000000000000000000000000000000000000000
0000000000000000000000000000000000000000000000000000000000000000000000000000000000000000000000000000
0000000000000000000000000000000000000000000000000000000000000000000000000000000000000000000000000000
0000000000000000000000000000000000000000000000000000000000000000000000000000000000000000000000000000
0000000000000000000000000000000000000000000000000000000000000000000000000000000000000000000000000000
0000000000000000000000000000000000000000000000000000000000000000000000000000000000000000000000000000
0000000000000000000000000000000000000000000000000000000000000000000000000000000000000000000000000000
0000000000000000000000000000000000000000000000000000000000000000000000000000000000000000000000000000
0000000000000000000000000000000000000000000000000000000000000000000000000000000000000000000000000000
0000000000000000000000000000000000000000000000000000000000000000000000000000000000000000000000000000
0000000000000000000000000000000000000000000000000000000000000000000000000000000000000000000000000000
0000000000000000000000000000000000000000000000000000000000000000000000000000000000000000000000000000
0000000000000000000000000000000000000000000000000000000000000000000000000000000000000000000000000000
0000000000000000000000000000000000000000000000000000000000000000000000000000000000000000000000000000
0000000000000000000000000000000000000000000000000000000000000000000000000000000000000000000000000000
0000000000000000000000000000000000000000000000000000000000000000000000000000000000000000000000000000
0000000000000000000000000000000000000000000000000000000000000000000000000000000000000000000000000000
0000000000000000000000000000000000000000000000000000000000000000000000000000000000000000000000000000
0000000000000000000000000000000000000000000000000000000000000000000000000000000000000000000000000000
0000000000000000000000000000000000000000000000000000000000000000000000000000000000000000000000000000
0000000000000000000000000000000000000000000000000000000000000000000000000000000000000000000000000000
0000000000000000000000000000000000000000000000000000000000000000000000000000000000000000000000000000
0000000000000000000000000000000000000000000000000000000000000000000000000000000000000000000000000000
0000000000000000000000000000000000000000000000000000000000000000000000000000000000000000000000000000
0000000000000000000000000000000000000000000000000000000000000000000000000000000000000000000000000000
0000000000000000000000000000000000000000000000000000000000000000000000000000000000000000000000000000
0000000000000000000000000000000000000000000000000000000000000000000000000000000000000000000000000000
0000000000000000000000000000000000000000000000000000000000000000000000000000000000000000000000000000
0000000000000000000000000000000000000000000000000000000000000000000000000000000000000000000000000000
0000000000000000000000000000000000000000000000000000000000000000000000000000000000000000000000000000
0000000000000000000000000000000000000000000000000000000000000000000000000000000000000000000000000000
0000000000000000000000000000000000000000000000000000000000000000000000000000000000000000000000000000
0000000000000000000000000000000000000000000000000000000000000000000000000000000000000000000000000000
0000000000000000000000000000000000000000000000000000000000000000000000000000000000000000000000000000
0000000000000000000000000000000000000000000000000000000000000000000000000000000000000000000000000000
0000000000000000000000000000000000000000000000000000000000000000000000000000000000000000000000000000
0000000000000000000000000000000000000000000000000000000000000000000000000000000000000000000000000000
0000000000000000000000000000000000000000000000000000000000000000000000000000000000000000000000000000
0000000000000000000000000000000000000000000000000000000000000000000000000000000000000000000000000000
0000000000000000000000000000000000000000000000000000000000000000000000000000000000000000000000000000
0000000000000000000000000000000000000000000000000000000000000000000000000000000000000000000000000000
0000000000000000000000000000000000000000000000000000000000000000000000000000000000000000000000000000
0000000000000000000000000000000000000000000000000000000000000000000000000000000000000000000000000000
0000000000000000000000000000000000000000000000000000000000000000000000000000000000000000000000000000
0000000000000000000000000000000000000000000000000000000000000000000000000000000000000000000000000000
0000000000000000000000000000000000000000000000000000000000000000000000000000000000000000000000000000
0000000000000000000000000000000000000000000000000000000000000000000000000000000000000000000000000000
0000000000000000000000000000000000000000000000000000000000000000000000000000000000000000000000000000
0000000000000000000000000000000000000000000000000000000000000000000000000000000000000000000000000000
0000000000000000000000000000000000000000000000000000000000000000000000000000000000000000000000000000
0000000000000000000000000000000000000000000000000000000000000000000000000000000000000000000000000000
0000000000000000000000000000000000000000000000000000000000000000000000000000000000000000000000000000
0000000000000000000000000000000000000000000000000000000000000000000000000000000000000000000000000000
0000000000000000000000000000000000000000000000000000000000000000000000000000000000000000000000000000
0000000000000000000000000000000000000000000000000000000000000000000000000000000000000000000000000000
0000000000000000000000000000000000000000000000000000000000000000000000000000000000000000000000000000
0000000000000000000000000000000000000000000000000000000000000000000000000000000000000000000000000000
0000000000000000000000000000000000000000000000000000000000000000000000000000000000000000000000000000
0000000000000000000000000000000000000000000000000000000000000000000000000000000000000000000000000000
level2.txt valid