0000000000000000000000000000000000000000000000000000000000000000000000000000000000000000000000000000
0000000000000000000000000000000000000000000000000000000000000000000000000000000000000000000000000000
0000111111111111111111111111111111111111111111111111111100000000000000000000000000000000000000000000
00001..................................................100000000000000000000000000000000000000000000
00001..................................................100000000000000000000000000000000000000000000
00001..................................................100000000000000000000000000000000000000000000
00001..................................................100000000000000000000000000000000000000000000
00001..................................................100000000000000000000000000000000000000000000
00001........P.........................................100000000000000000000000000000000000000000000
00111..................................................100000000000000000000000000000000000000000000
001....................................................100000000000000000000000000000000000000000000
001....................................................110000000000000000000000000000000000000000000
011.....................................................11000000000000000000000000000000000000000000
01......................................................11111111111111111111111111111111111111111111
01.................................................................................................1
01.................................................................................................1
01..............................1111111111111......................................................1
01..............................1000000000001......................................................1
01..............................1000000000001.......................M...B..........................1
01..............................1000000000001......................................................1
01..............................100000000000111111111111111111.....................................1
01..............................100000000000000000000000000001.....................................1
01..............................100000000000000000000000000001.....................................1
01..............................100000000000000000000000000001.....................................1
01..............................100000000000000000000000000001.....................................1
01..............................100000000000000000000000000001111111...............................1
01..............................1000000000000000000000000000000000011..............................1
01..............................10000000000000000000000000000000000111.............................1
01..............................10000000000000000000000000000000000001.............................1
01..............................10000000000000000000000000000000000001.............................1
01..............................10000000000000000000000000000000000001.............................1
01..............................10000000000000000000000000000000000001.............................1
01..............................10000000000000000000000000000000000001.............................1
01..............................10000000000000000000000000000000000001.............................1
01..............................100000000000000000000000000000000000011111.........................1
01..............................100000000000000000000000000000000000000001.........................1
01..............................100000000000000000000000000000000000000001.........................1
01..............................100000000000000000000000000000000000000001.........................1
01..............................100000000000000000000000000000000000000001.........................1
01..............................100000000000000000000000000000000000000001.........................1
01..............................100000000000000000000000000000000000000001.........................1
01..............................100000000000000000000000000000000000000001.........................1
01..............................100000000000000000000000000000000000000001.........................1
01..............................100000000000000000000000000000000000000001.........................1
01..............................100000000000000000000000000000000000000001.........................1
01..............................100000000000000000000000000000000000000001.........................1
01..............................100000000000000000000000000000000000000001.........................1
01..............................100000000000000000000000000000000000000001.........................1
01..............................100000000000000000000000000000000000000001.........................1
01..............................100000000000000000000000000000000000000001.........................1
01..............................100000000000000000000000000000000000000001.........................1
01..............................100000000000000000000000000000000000000001.........................1
01..............................100000000000000000000000000000000000000001.........................1
01..............................100000000000000000000000000000000000000001.........................1
01..............................100000000000000000000000000000000000000001..................B......1
01..............................100000000000000000000000000000000000000001.........................1
01..............................100000000000000000000000000000000000000001.........................1
01..............................100000000000000000000000000000000000000001..................J......1
01..............................100000000000000000000000000000000000000001.........................1
01..............................100000000000000000000000000000000000000001.........................1
01..............................100000000000000000000000000000000000000001.........................1
01..............................100000000000000000000000000000000000000001.........................1
01..............................100000000000000000000000000000000000000001.........................1
01..............................100000000000000000000000000000000000000001.........................1
01..............................100000000000000000000000000000000000000001.........................1
01..............................100000000000000000000000000000000000000001.........................1
01..............................100000000000000000000000000000000000000001.........................1
01..............................100000000000000000000000000000001111111111.........................1
01..............................100000000000000000000000000000001..................................1
01..............................111111111111111111111111111111111..................................1
01.................................................................................................1
01.................................................................................................1
01.................................................................................................1
01.................................................................................................1
01.................................................................................................1
01.................................................................................................1
01.................................................................................................1
01.................................................................................................1
01.................................................................................................1
01...................................................................................X.............1
01111111111111111111...............................................................................1
0000000000000000000111111111111111111111111111111111111111111111111111111111111111111111111111111111
0000000000000000000000000000000000000000000000000000000000000000000000000000000000000000000000000000
0000000000000000000000000000000000000000000000000000000000000000000000000000000000000000000000000000
0000000000000000000000000000000000000000000000000000000000000000000000000000000000000000000000000000
0000000000000000000000000000000000000000000000000000000000000000000000000000000000000000000000000000
0000000000000000000000000000000000000000000000000000000000000000000000000000000000000000000000000000
0000000000000000000000000000000000000000000000000000000000000000000000000000000000000000000000000000
0000000000000000000000000000000000000000000000000000000000000000000000000000000000000000000000000000
0000000000000000000000000000000000000000000000000000000000000000000000000000000000000000000000000000
0000000000000000000000000000000000000000000000000000000000000000000000000000000000000000000000000000
0000000000000000000000000000000000000000000000000000000000000000000000000000000000000000000000000000
0000000000000000000000000000000000000000000000000000000000000000000000000000000000000000000000000000
0000000000000000000000000000000000000000000000000000000000000000000000000000000000000000000000000000
0000000000000000000000000000000000000000000000000000000000000000000000000000000000000000000000000000
0000000000000000000000000000000000000000000000000000000000000000000000000000000000000000000000000000
0000000000000000000000000000000000000000000000000000000000000000000000000000000000000000000000000000
0000000000000000000000000000000000000000000000000000000000000000000000000000000000000000000000000000
0000000000000000000000000000000000000000000000000000000000000000000000000000000000000000000000000000
0000000000000000000000000000000000000000000000000000000000000000000000000000000000000000000000000000
level3.txt valid